//MAP CONVERTED BY dmm2tgm.py THIS HEADER COMMENT PREVENTS RECONVERSION, DO NOT REMOVE
"ak" = (
/turf/open/floor/plasteel/dark,
/area/ship/hallway/starboard)
"aF" = (
/turf/closed/wall/mineral/titanium/nodiagonal,
/area/ship/security/armory)
"bf" = (
/turf/open/floor/plasteel/white,
/area/ship/cargo/port)
"bS" = (
/turf/open/floor/plasteel/dark,
/area/ship/hallway/port)
"bY" = (
/obj/structure/cable{
	icon_state = "4-8"
	},
/turf/open/floor/plasteel/white,
/area/ship/engineering/electrical)
"df" = (
/turf/open/floor/plasteel/mono/white,
/area/space)
"dA" = (
/turf/closed/wall/mineral/titanium/nodiagonal,
/area/ship/security)
"dU" = (
/turf/closed/wall/mineral/titanium/nodiagonal,
/area/ship/engineering/engine)
"dY" = (
/turf/open/floor/plasteel/white,
/area/ship/science/robotics)
"eN" = (
/obj/machinery/power/shuttle/engine/electric{
	dir = 4
	},
/turf/open/floor/plating,
/area/ship/maintenance/port)
"eS" = (
/turf/closed/wall/mineral/titanium,
/area/ship/storage/eva)
"gx" = (
/turf/closed/wall/mineral/titanium/nodiagonal,
/area/ship/science/robotics)
"hJ" = (
/turf/open/floor/plasteel/mono/white,
/area/ship/hallway/fore)
"iN" = (
/turf/open/floor/plasteel/stairs/medium,
/area/ship/maintenance/port)
"js" = (
/obj/structure/cable/yellow{
	icon_state = "1-8"
	},
/obj/structure/cable/yellow{
	icon_state = "4-8"
	},
/turf/closed/wall/mineral/titanium/nodiagonal,
/area/ship/engineering/engine)
"jw" = (
/turf/open/floor/plasteel/mono/white,
/area/ship/cargo/port)
"jH" = (
/turf/open/floor/plasteel/mono/dark,
/area/ship/maintenance/port)
"lj" = (
/turf/open/floor/plasteel/mono/white,
/area/ship/science/robotics)
"lI" = (
/obj/structure/cable/yellow{
	icon_state = "1-8"
	},
/turf/closed/wall/mineral/titanium/nodiagonal,
/area/ship/engineering/electrical)
"lW" = (
/turf/open/floor/plasteel/white,
/area/ship/engineering/atmospherics)
"ms" = (
/turf/open/floor/plasteel/white,
/area/ship/security/armory)
"ne" = (
/turf/open/floor/plasteel/stairs/medium{
	dir = 1
	},
/area/ship/maintenance/port)
"nk" = (
/obj/machinery/power/generator{
	dir = 8
	},
/obj/structure/cable/yellow{
	icon_state = "1-2"
	},
/turf/open/floor/engine/air,
/area/ship/engineering/engine)
"nJ" = (
/obj/structure/cable{
	icon_state = "2-4"
	},
/obj/structure/cable{
	icon_state = "4-8"
	},
/turf/open/floor/plasteel/white,
/area/ship/engineering/electrical)
"nT" = (
/turf/open/floor/plasteel/stairs/right,
/area/ship/maintenance/port)
"pb" = (
/turf/open/floor/plasteel/mono/white,
/area/ship/engineering/atmospherics)
"pc" = (
/turf/open/floor/plasteel/stairs/left{
	dir = 1
	},
/area/ship/maintenance/port)
"pp" = (
/obj/machinery/atmospherics/components/binary/circulator{
	dir = 1
	},
/turf/open/floor/engine/air,
/area/ship/engineering/engine)
"py" = (
/turf/closed/wall/mineral/titanium,
/area/ship/hallway/port)
"pA" = (
/turf/closed/wall/mineral/titanium,
/area/space)
"qh" = (
/turf/open/floor/plasteel/white,
/area/ship/cargo/starboard)
"rj" = (
/turf/open/floor/plasteel/mono/white,
/area/ship/security/armory)
"rE" = (
/turf/open/floor/plasteel/white,
/area/ship/security)
"rL" = (
/turf/open/floor/plasteel/mono/white,
/area/ship/engineering/electrical)
"to" = (
/obj/machinery/atmospherics/components/binary/circulator/cold,
/obj/structure/cable/yellow{
	icon_state = "1-2"
	},
/turf/open/floor/engine/air,
/area/ship/engineering/engine)
"uH" = (
/obj/machinery/power/terminal{
	dir = 8
	},
/obj/structure/cable/yellow{
	icon_state = "0-2"
	},
/turf/open/floor/plasteel/white,
/area/ship/engineering/electrical)
"vj" = (
/turf/closed/wall/mineral/titanium,
/area/ship/hallway/starboard)
"vr" = (
/turf/open/floor/plasteel/mono/white,
/area/ship/engineering/engine)
"vy" = (
/turf/closed/wall/mineral/titanium/nodiagonal,
/area/ship/engineering/electrical)
"ws" = (
/turf/template_noop,
/area/template_noop)
"wJ" = (
/turf/open/floor/plasteel/white,
/area/ship/bridge)
"xg" = (
/obj/structure/window/plasma/reinforced/spawner,
/obj/structure/window/plasma/reinforced/spawner/east,
/obj/structure/window/plasma/reinforced/spawner/north,
/turf/open/floor/engine/air,
/area/ship/engineering/atmospherics)
"xk" = (
/obj/structure/cable/yellow{
	icon_state = "2-4"
	},
/turf/closed/wall/mineral/titanium/nodiagonal,
/area/ship/engineering/engine)
"xY" = (
/obj/machinery/power/terminal{
	dir = 4
	},
/obj/structure/cable/yellow{
	icon_state = "0-2"
	},
/turf/open/floor/plasteel/white,
/area/ship/engineering/electrical)
"yE" = (
/turf/open/floor/plasteel/white,
/area/ship/engineering/engine)
"yQ" = (
/obj/effect/turf_decal/atmos/air{
	pixel_x = -37
	},
/turf/open/floor/plasteel/white,
/area/ship/engineering/atmospherics)
"yU" = (
/obj/structure/window/plasma/reinforced/spawner,
/obj/structure/window/plasma/reinforced/spawner/north,
/obj/structure/window/plasma/reinforced/spawner/west,
/turf/open/floor/engine/plasma,
/area/ship/engineering/atmospherics)
"yX" = (
/turf/open/floor/engine/hull/reinforced,
/area/ship/external)
"zg" = (
/turf/open/floor/plasteel/mono/dark,
/area/ship/hallway/port)
"zH" = (
/turf/closed/wall/mineral/titanium/nodiagonal,
/area/ship/hallway/port)
"AO" = (
/turf/open/floor/plasteel/tech/grid,
/area/ship/storage/eva)
"Bc" = (
/turf/open/floor/plasteel/mono/white,
/area/ship/storage/eva)
"BO" = (
/turf/closed/wall/mineral/titanium/nodiagonal,
/area/ship/storage/eva)
"CF" = (
/turf/closed/wall/mineral/titanium,
/area/ship/maintenance/port)
"Dr" = (
/turf/closed/wall/mineral/titanium/nodiagonal,
/area/ship/cargo/starboard)
"DP" = (
/turf/open/floor/plasteel/white,
/area/ship/hallway/fore)
"ET" = (
/turf/closed/wall/mineral/titanium,
/area/ship/engineering/atmospherics)
"Fo" = (
/turf/closed/wall/mineral/titanium/nodiagonal,
/area/ship/engineering/atmospherics)
"Fr" = (
/turf/open/floor/plasteel/mono/white,
/area/ship/medical)
"Gn" = (
/turf/closed/wall/mineral/titanium/nodiagonal,
/area/ship/bridge)
"Hl" = (
/turf/open/floor/plasteel/mono/dark,
/area/ship/hallway/starboard)
"Hs" = (
/turf/open/floor/plasteel/mono/white,
/area/ship/security)
"Jo" = (
/turf/open/floor/plasteel/white,
/area/ship/medical)
"Kn" = (
/turf/closed/wall/mineral/titanium/nodiagonal,
/area/ship/hallway/starboard)
"Li" = (
/obj/machinery/power/shuttle/engine/fueled/plasma{
	dir = 4
	},
/turf/open/floor/plating,
/area/ship/maintenance/port)
"LU" = (
/turf/open/floor/plasteel/stairs/left,
/area/ship/maintenance/port)
"Ma" = (
/turf/open/floor/plasteel/tech/grid,
/area/ship/cargo/starboard)
"Mb" = (
/obj/machinery/power/smes/engineering,
/obj/structure/cable,
/turf/open/floor/plasteel/white,
/area/ship/engineering/electrical)
"MI" = (
/turf/open/floor/plasteel/white,
/area/ship/storage/eva)
"NG" = (
/turf/closed/wall/mineral/titanium/nodiagonal,
/area/ship/cargo/port)
"QH" = (
/turf/open/floor/plasteel/white,
/area/ship/engineering/electrical)
"QN" = (
/turf/closed/wall/mineral/titanium/nodiagonal,
/area/ship/hallway/fore)
"RB" = (
/turf/open/floor/plasteel/dark,
/area/ship/maintenance/port)
"RQ" = (
/obj/structure/window/plasma/reinforced/spawner,
/obj/structure/window/plasma/reinforced/spawner/east,
/obj/structure/window/plasma/reinforced/spawner/north,
/turf/open/floor/engine/plasma,
/area/ship/engineering/atmospherics)
"RT" = (
/obj/effect/spawner/structure/window/plasma/reinforced,
/turf/open/floor/engine/air,
/area/ship/engineering/engine)
"So" = (
/turf/open/floor/engine/airless,
/area/ship/engineering/engine)
"Tv" = (
/obj/structure/cable/yellow{
	icon_state = "1-2"
	},
/turf/closed/wall/mineral/titanium/nodiagonal,
/area/ship/engineering/engine)
"TI" = (
/turf/open/floor/plasteel/mono/white,
/area/ship/cargo/starboard)
"TT" = (
/obj/structure/cable{
	icon_state = "2-8"
	},
/obj/structure/cable{
	icon_state = "0-8"
	},
/obj/machinery/power/apc/auto_name/directional/north,
/turf/open/floor/plasteel/white,
/area/ship/engineering/electrical)
"Ub" = (
/turf/open/floor/plasteel/tech/grid,
/area/ship/cargo/port)
"UU" = (
/turf/closed/wall/mineral/titanium,
/area/ship/bridge)
"VA" = (
/turf/open/floor/plasteel/stairs/right{
	dir = 1
	},
/area/ship/maintenance/port)
"VI" = (
/turf/closed/wall/mineral/titanium/nodiagonal,
/area/space)
"WL" = (
/turf/open/floor/plasteel/white,
/area/space)
"Xv" = (
/obj/structure/window/plasma/reinforced/spawner,
/obj/structure/window/plasma/reinforced/spawner/north,
/obj/structure/window/plasma/reinforced/spawner/west,
/turf/open/floor/engine/air,
/area/ship/engineering/atmospherics)
"XX" = (
/turf/closed/wall/mineral/titanium/nodiagonal,
/area/ship/medical)
"Yj" = (
/obj/structure/cable/yellow{
	icon_state = "4-8"
	},
/turf/closed/wall/mineral/titanium/nodiagonal,
/area/ship/engineering/engine)
"Yp" = (
/turf/closed/wall/mineral/titanium/nodiagonal,
/area/ship/maintenance/port)
"YG" = (
/turf/open/floor/engine,
/area/ship/maintenance/port)
"YZ" = (
/obj/effect/turf_decal/atmos/plasma{
	pixel_x = -35
	},
/turf/open/floor/plasteel/white,
/area/ship/engineering/atmospherics)
"ZM" = (
/turf/open/floor/plasteel/mono/dark,
/area/ship/science/robotics)
"ZW" = (
/turf/open/floor/plasteel/dark,
/area/ship/engineering/engine)

(1,1,1) = {"
ws
ws
ws
ws
ws
ws
ws
ws
ws
ws
eS
AO
AO
AO
AO
AO
eS
ws
ws
ws
ws
ws
ws
ws
ws
ws
ws
"}
(2,1,1) = {"
ws
ws
ws
ws
ws
ws
ws
ws
ws
eS
BO
MI
MI
MI
MI
MI
BO
eS
ws
ws
ws
ws
ws
ws
ws
ws
ws
"}
(3,1,1) = {"
ws
ws
ws
ws
ws
ws
ws
ws
eS
BO
BO
MI
MI
MI
MI
MI
BO
BO
eS
ws
ws
ws
ws
ws
ws
ws
ws
"}
(4,1,1) = {"
ws
eN
Li
eN
ws
ws
ws
ET
Fo
Fo
BO
BO
Bc
BO
Bc
BO
BO
VI
VI
pA
ws
ws
ws
eN
Li
eN
ws
"}
(5,1,1) = {"
Yp
YG
YG
YG
Yp
ws
ws
Fo
Xv
yU
dU
yE
yE
yE
yE
yE
dU
WL
WL
VI
ws
ws
Yp
YG
YG
YG
Yp
"}
(6,1,1) = {"
Yp
YG
YG
YG
Yp
ws
ws
Fo
xg
RQ
dU
yE
yE
yE
yE
yE
dU
WL
WL
VI
ws
ws
Yp
YG
YG
YG
Yp
"}
(7,1,1) = {"
Yp
YG
YG
YG
Yp
ws
ET
Fo
yQ
YZ
dU
yE
yE
yE
yE
yE
dU
WL
WL
VI
pA
ws
Yp
YG
YG
YG
Yp
"}
(8,1,1) = {"
Yp
YG
YG
YG
Yp
ws
Fo
Fo
lW
lW
vr
yE
yE
yE
yE
yE
vr
WL
WL
VI
VI
ws
Yp
YG
YG
YG
Yp
"}
(9,1,1) = {"
Yp
YG
YG
YG
Yp
ws
Fo
Fo
lW
lW
dU
yE
yE
yE
yE
yE
dU
WL
WL
VI
VI
ws
Yp
YG
YG
YG
Yp
"}
(10,1,1) = {"
Yp
YG
YG
YG
Yp
yX
Fo
Fo
pb
Fo
xk
Tv
to
nk
pp
dU
dU
VI
df
VI
VI
yX
Yp
YG
YG
YG
Yp
"}
(11,1,1) = {"
Yp
YG
YG
YG
Yp
Yp
Yp
vy
QH
xY
js
ZW
RT
RT
RT
ZW
dU
WL
WL
VI
Yp
Yp
Yp
YG
YG
YG
Yp
"}
(12,1,1) = {"
Yp
YG
YG
YG
pc
RB
RB
vy
nJ
Mb
Yj
ZW
So
So
So
ZW
dU
WL
WL
VI
RB
RB
LU
YG
YG
YG
Yp
"}
(13,1,1) = {"
Yp
YG
YG
YG
ne
RB
RB
vy
nJ
Mb
Yj
dU
dU
dU
dU
dU
dU
WL
WL
VI
RB
RB
iN
YG
YG
YG
Yp
"}
(14,1,1) = {"
Yp
YG
YG
YG
ne
RB
RB
vy
bY
uH
lI
ms
ms
ms
ms
ms
aF
WL
WL
VI
RB
RB
iN
YG
YG
YG
Yp
"}
(15,1,1) = {"
Yp
YG
YG
YG
VA
RB
RB
vy
TT
QH
rL
ms
ms
ms
ms
ms
rj
WL
WL
VI
RB
RB
nT
YG
YG
YG
Yp
"}
(16,1,1) = {"
CF
Yp
Yp
Yp
Yp
RB
RB
vy
vy
vy
vy
ms
ms
ms
ms
ms
aF
VI
VI
VI
RB
RB
Yp
Yp
Yp
Yp
CF
"}
(17,1,1) = {"
ws
CF
Yp
Yp
Yp
RB
RB
RB
RB
RB
jH
ms
ms
ms
ms
ms
jH
RB
RB
RB
RB
RB
Yp
Yp
Yp
CF
ws
"}
(18,1,1) = {"
ws
ws
ws
ws
Yp
RB
RB
RB
RB
RB
aF
ms
ms
ms
ms
ms
aF
RB
RB
RB
RB
RB
Yp
ws
ws
ws
ws
"}
(19,1,1) = {"
ws
ws
ws
ws
NG
NG
NG
NG
VI
VI
aF
rj
aF
aF
aF
rj
aF
VI
VI
Dr
Dr
Dr
Dr
ws
ws
ws
ws
"}
(20,1,1) = {"
ws
ws
ws
ws
Ub
bf
bf
NG
WL
WL
WL
WL
WL
VI
WL
WL
WL
WL
WL
Dr
qh
qh
Ma
ws
ws
ws
ws
"}
(21,1,1) = {"
ws
ws
ws
ws
Ub
bf
bf
NG
WL
WL
WL
WL
WL
VI
WL
WL
WL
WL
WL
Dr
qh
qh
Ma
ws
ws
ws
ws
"}
(22,1,1) = {"
ws
ws
ws
ws
Ub
bf
bf
NG
WL
WL
WL
WL
WL
VI
WL
WL
WL
WL
WL
Dr
qh
qh
Ma
ws
ws
ws
ws
"}
(23,1,1) = {"
ws
ws
ws
ws
Ub
bf
bf
jw
WL
WL
WL
WL
WL
VI
WL
WL
WL
WL
WL
TI
qh
qh
Ma
ws
ws
ws
ws
"}
(24,1,1) = {"
ws
ws
ws
ws
Ub
bf
bf
NG
WL
WL
WL
WL
WL
VI
WL
WL
WL
WL
WL
Dr
qh
qh
Ma
ws
ws
ws
ws
"}
(25,1,1) = {"
ws
ws
ws
ws
NG
NG
Hl
NG
XX
Fr
XX
XX
XX
XX
VI
VI
VI
df
VI
Dr
Hl
Dr
Dr
ws
ws
ws
ws
"}
(26,1,1) = {"
ws
ws
ws
ws
Kn
ak
ak
XX
Jo
Jo
Jo
Jo
Jo
XX
WL
WL
WL
WL
WL
Kn
ak
ak
Kn
ws
ws
ws
ws
"}
(27,1,1) = {"
ws
ws
ws
ws
vj
Kn
ak
XX
Jo
Jo
Jo
Jo
Jo
Fr
WL
WL
WL
WL
WL
Kn
ak
Kn
vj
ws
ws
ws
ws
"}
(28,1,1) = {"
ws
ws
ws
ws
ws
Kn
ak
XX
Jo
Jo
Jo
Jo
Jo
XX
WL
WL
WL
WL
WL
Kn
ak
Kn
ws
ws
ws
ws
ws
"}
(29,1,1) = {"
ws
ws
ws
ws
ws
vj
Kn
XX
Jo
Jo
Jo
Jo
Jo
XX
WL
WL
WL
WL
WL
Kn
Kn
vj
ws
ws
ws
ws
ws
"}
(30,1,1) = {"
ws
ws
ws
ws
ws
ws
Kn
XX
Jo
Jo
Jo
Jo
Jo
XX
WL
WL
WL
WL
WL
Kn
Kn
ws
ws
ws
ws
ws
ws
"}
(31,1,1) = {"
ws
ws
ws
ws
ws
ws
py
zH
zg
zH
QN
QN
hJ
QN
Hs
dA
dA
Kn
Hl
Kn
vj
ws
ws
ws
ws
ws
ws
"}
(32,1,1) = {"
ws
ws
ws
ws
ws
ws
ws
zH
bS
bS
QN
DP
DP
QN
rE
rE
dA
ak
ak
Kn
ws
ws
ws
ws
ws
ws
ws
"}
(33,1,1) = {"
ws
ws
ws
ws
ws
ws
ws
zH
bS
bS
QN
DP
DP
QN
rE
rE
dA
ak
ak
Kn
ws
ws
ws
ws
ws
ws
ws
"}
(34,1,1) = {"
ws
ws
ws
ws
ws
ws
ws
zH
bS
bS
QN
DP
DP
QN
rE
rE
dA
ak
ak
Kn
ws
ws
ws
ws
ws
ws
ws
"}
(35,1,1) = {"
ws
ws
ws
ws
ws
ws
ws
zH
bS
bS
QN
DP
DP
QN
rE
rE
dA
ak
ak
Kn
ws
ws
ws
ws
ws
ws
ws
"}
(36,1,1) = {"
ws
ws
ws
ws
ws
ws
ws
py
zH
bS
QN
DP
DP
QN
rE
rE
dA
ak
Kn
vj
ws
ws
ws
ws
ws
ws
ws
"}
(37,1,1) = {"
ws
ws
ws
ws
ws
ws
ws
ws
zH
bS
QN
QN
hJ
QN
Hs
dA
dA
ak
Kn
ws
ws
ws
ws
ws
ws
ws
ws
"}
(38,1,1) = {"
ws
ws
ws
ws
ws
ws
ws
ws
zH
bS
ZM
dY
dY
dY
dY
dY
ZM
ak
Kn
ws
ws
ws
ws
ws
ws
ws
ws
"}
(39,1,1) = {"
ws
ws
ws
ws
ws
ws
ws
ws
zH
bS
gx
dY
dY
dY
dY
dY
gx
ak
Kn
ws
ws
ws
ws
ws
ws
ws
ws
"}
(40,1,1) = {"
ws
ws
ws
ws
ws
ws
ws
ws
py
zH
gx
dY
dY
dY
dY
dY
gx
Kn
vj
ws
ws
ws
ws
ws
ws
ws
ws
"}
(41,1,1) = {"
ws
ws
ws
ws
ws
ws
ws
ws
ws
gx
gx
dY
dY
dY
dY
dY
gx
gx
ws
ws
ws
ws
ws
ws
ws
ws
ws
"}
(42,1,1) = {"
ws
ws
ws
ws
ws
ws
ws
ws
ws
gx
gx
dY
dY
dY
dY
dY
gx
gx
ws
ws
ws
ws
ws
ws
ws
ws
ws
"}
(43,1,1) = {"
ws
ws
ws
ws
ws
ws
ws
ws
ws
Gn
gx
gx
gx
gx
lj
gx
gx
Gn
ws
ws
ws
ws
ws
ws
ws
ws
ws
"}
(44,1,1) = {"
ws
ws
ws
ws
ws
ws
ws
ws
ws
Gn
Gn
wJ
wJ
wJ
wJ
wJ
Gn
Gn
ws
ws
ws
ws
ws
ws
ws
ws
ws
"}
(45,1,1) = {"
ws
ws
ws
ws
ws
ws
ws
ws
ws
UU
Gn
wJ
wJ
wJ
wJ
wJ
Gn
UU
ws
ws
ws
ws
ws
ws
ws
ws
ws
"}
(46,1,1) = {"
ws
ws
ws
ws
ws
ws
ws
ws
ws
ws
UU
Gn
Gn
Gn
Gn
Gn
UU
ws
ws
ws
ws
ws
ws
ws
ws
ws
ws
"}
