//MAP CONVERTED BY dmm2tgm.py THIS HEADER COMMENT PREVENTS RECONVERSION, DO NOT REMOVE
"a" = (
/turf/open/space/basic,
/area/space)
"d" = (
/turf/closed/wall/mineral/titanium/nodiagonal,
/area/space)
"e" = (
/turf/open/floor/plasteel/stairs/right,
/area/space)
"x" = (
/turf/open/floor/plasteel/stairs/left,
/area/space)
"F" = (
/turf/open/floor/plasteel/stairs/medium,
/area/space)
"G" = (
/turf/open/floor/plasteel/stairs/right{
	dir = 1
	},
/area/space)
"H" = (
/turf/open/floor/plasteel/stairs/medium{
	dir = 1
	},
/area/space)
"M" = (
/turf/open/floor/plasteel/dark,
/area/space)
"Q" = (
/turf/open/floor/plating,
/area/space)
"X" = (
/turf/open/floor/plasteel/stairs/left{
	dir = 1
	},
/area/space)
"Z" = (
/turf/open/floor/plasteel/white,
/area/space)

(1,1,1) = {"
a
a
a
a
a
a
a
a
a
a
d
Q
Q
Q
Q
Q
d
a
a
a
a
a
a
a
a
a
a
"}
(2,1,1) = {"
a
a
a
a
a
a
a
a
a
d
d
Z
Z
Z
Z
Z
d
d
a
a
a
a
a
a
a
a
a
"}
(3,1,1) = {"
a
a
a
a
a
a
a
a
d
d
d
Z
Z
Z
Z
Z
d
d
d
a
a
a
a
a
a
a
a
"}
(4,1,1) = {"
a
a
a
a
a
a
a
d
d
d
d
d
d
d
d
d
d
d
d
d
a
a
a
a
a
a
a
"}
(5,1,1) = {"
d
Q
Q
Q
d
a
a
d
Z
Z
d
Z
Z
Z
Z
Z
d
Z
Z
d
a
a
d
Q
Q
Q
d
"}
(6,1,1) = {"
d
M
M
M
d
a
a
d
Z
Z
d
Z
Z
Z
Z
Z
d
Z
Z
d
a
a
d
M
M
M
d
"}
(7,1,1) = {"
d
M
M
M
d
a
d
d
Z
Z
d
Z
Z
Z
Z
Z
d
Z
Z
d
d
a
d
M
M
M
d
"}
(8,1,1) = {"
d
M
M
M
d
a
d
d
Z
Z
d
Z
Z
Z
Z
Z
d
Z
Z
d
d
a
d
M
M
M
d
"}
(9,1,1) = {"
d
M
M
M
d
a
d
d
Z
Z
d
Z
Z
Z
Z
Z
d
Z
Z
d
d
a
d
M
M
M
d
"}
(10,1,1) = {"
d
M
M
M
d
a
d
d
d
d
d
d
d
d
d
d
d
d
d
d
d
a
d
M
M
M
d
"}
(11,1,1) = {"
d
M
M
M
d
d
d
d
Z
Z
d
M
M
M
M
M
d
Z
Z
d
d
d
d
M
M
M
d
"}
(12,1,1) = {"
d
M
M
M
X
M
M
d
Z
Z
d
M
M
M
M
M
d
Z
Z
d
M
M
x
M
M
M
d
"}
(13,1,1) = {"
d
M
M
M
H
M
M
d
Z
Z
d
d
d
d
d
d
d
Z
Z
d
M
M
F
M
M
M
d
"}
(14,1,1) = {"
d
M
M
M
H
M
M
d
Z
Z
d
Z
Z
Z
Z
Z
d
Z
Z
d
M
M
F
M
M
M
d
"}
(15,1,1) = {"
d
M
M
M
G
M
M
d
Z
Z
d
Z
Z
Z
Z
Z
d
Z
Z
d
M
M
e
M
M
M
d
"}
(16,1,1) = {"
d
d
d
d
d
M
M
d
d
d
d
Z
Z
Z
Z
Z
d
d
d
d
M
M
d
d
d
d
d
"}
(17,1,1) = {"
a
d
d
d
d
M
M
M
M
M
d
Z
Z
Z
Z
Z
d
M
M
M
M
M
d
d
d
d
a
"}
(18,1,1) = {"
a
a
a
a
d
M
M
M
M
M
d
Z
Z
Z
Z
Z
d
M
M
M
M
M
d
a
a
a
a
"}
(19,1,1) = {"
a
a
a
a
d
d
d
d
d
d
d
d
d
d
d
d
d
d
d
d
d
d
d
a
a
a
a
"}
(20,1,1) = {"
a
a
a
a
Q
Z
Z
d
Z
Z
Z
Z
Z
d
Z
Z
Z
Z
Z
d
Z
Z
Q
a
a
a
a
"}
(21,1,1) = {"
a
a
a
a
Q
Z
Z
d
Z
Z
Z
Z
Z
d
Z
Z
Z
Z
Z
d
Z
Z
Q
a
a
a
a
"}
(22,1,1) = {"
a
a
a
a
Q
Z
Z
d
Z
Z
Z
Z
Z
d
Z
Z
Z
Z
Z
d
Z
Z
Q
a
a
a
a
"}
(23,1,1) = {"
a
a
a
a
Q
Z
Z
d
Z
Z
Z
Z
Z
d
Z
Z
Z
Z
Z
d
Z
Z
Q
a
a
a
a
"}
(24,1,1) = {"
a
a
a
a
Q
Z
Z
d
Z
Z
Z
Z
Z
d
Z
Z
Z
Z
Z
d
Z
Z
Q
a
a
a
a
"}
(25,1,1) = {"
a
a
a
a
d
d
d
d
d
d
d
d
d
d
d
d
d
d
d
d
d
d
d
a
a
a
a
"}
(26,1,1) = {"
a
a
a
a
d
M
M
d
Z
Z
Z
Z
Z
d
Z
Z
Z
Z
Z
d
M
M
d
a
a
a
a
"}
(27,1,1) = {"
a
a
a
a
d
d
M
d
Z
Z
Z
Z
Z
d
Z
Z
Z
Z
Z
d
M
d
d
a
a
a
a
"}
(28,1,1) = {"
a
a
a
a
a
d
M
d
Z
Z
Z
Z
Z
d
Z
Z
Z
Z
Z
d
M
d
a
a
a
a
a
"}
(29,1,1) = {"
a
a
a
a
a
d
d
d
Z
Z
Z
Z
Z
d
Z
Z
Z
Z
Z
d
d
d
a
a
a
a
a
"}
(30,1,1) = {"
a
a
a
a
a
a
d
d
Z
Z
Z
Z
Z
d
Z
Z
Z
Z
Z
d
d
a
a
a
a
a
a
"}
(31,1,1) = {"
a
a
a
a
a
a
d
d
d
d
d
d
d
d
d
d
d
d
d
d
d
a
a
a
a
a
a
"}
(32,1,1) = {"
a
a
a
a
a
a
a
d
M
M
d
Z
Z
d
Z
Z
d
M
M
d
a
a
a
a
a
a
a
"}
(33,1,1) = {"
a
a
a
a
a
a
a
d
M
M
d
Z
Z
d
Z
Z
d
M
M
d
a
a
a
a
a
a
a
"}
(34,1,1) = {"
a
a
a
a
a
a
a
d
M
M
d
Z
Z
d
Z
Z
d
M
M
d
a
a
a
a
a
a
a
"}
(35,1,1) = {"
a
a
a
a
a
a
a
d
M
M
d
Z
Z
d
Z
Z
d
M
M
d
a
a
a
a
a
a
a
"}
(36,1,1) = {"
a
a
a
a
a
a
a
d
d
M
d
Z
Z
d
Z
Z
d
M
d
d
a
a
a
a
a
a
a
"}
(37,1,1) = {"
a
a
a
a
a
a
a
a
d
M
d
d
d
d
d
d
d
M
d
a
a
a
a
a
a
a
a
"}
(38,1,1) = {"
a
a
a
a
a
a
a
a
d
M
d
Z
Z
Z
Z
Z
d
M
d
a
a
a
a
a
a
a
a
"}
(39,1,1) = {"
a
a
a
a
a
a
a
a
d
M
d
Z
Z
Z
Z
Z
d
M
d
a
a
a
a
a
a
a
a
"}
(40,1,1) = {"
a
a
a
a
a
a
a
a
d
d
d
Z
Z
Z
Z
Z
d
d
d
a
a
a
a
a
a
a
a
"}
(41,1,1) = {"
a
a
a
a
a
a
a
a
a
d
d
Z
Z
Z
Z
Z
d
d
a
a
a
a
a
a
a
a
a
"}
(42,1,1) = {"
a
a
a
a
a
a
a
a
a
d
d
Z
Z
Z
Z
Z
d
d
a
a
a
a
a
a
a
a
a
"}
(43,1,1) = {"
a
a
a
a
a
a
a
a
a
d
d
d
d
d
d
d
d
d
a
a
a
a
a
a
a
a
a
"}
(44,1,1) = {"
a
a
a
a
a
a
a
a
a
d
d
Z
Z
Z
Z
Z
d
d
a
a
a
a
a
a
a
a
a
"}
(45,1,1) = {"
a
a
a
a
a
a
a
a
a
d
d
Z
Z
Z
Z
Z
d
d
a
a
a
a
a
a
a
a
a
"}
(46,1,1) = {"
a
a
a
a
a
a
a
a
a
a
d
d
d
d
d
d
d
a
a
a
a
a
a
a
a
a
a
"}
