//MAP CONVERTED BY dmm2tgm.py THIS HEADER COMMENT PREVENTS RECONVERSION, DO NOT REMOVE
"ag" = (
/obj/structure/window/plasma/reinforced/spawner,
/obj/structure/window/plasma/reinforced/spawner/north,
/obj/structure/window/plasma/reinforced/spawner/west,
/obj/effect/turf_decal/atmos/oxygen,
/obj/machinery/atmospherics/components/unary/vent_pump/siphon/atmos/oxygen_output{
	dir = 4;
	piping_layer = 4
	},
/turf/open/floor/engine/air,
/area/ship/engineering/atmospherics)
"aM" = (
/turf/open/floor/plasteel/stairs/medium{
	dir = 1
	},
/area/ship/maintenance/port)
"bP" = (
/obj/machinery/power/terminal{
	dir = 8
	},
/obj/structure/cable/yellow{
	icon_state = "0-2"
	},
/turf/open/floor/plasteel/white,
/area/ship/engineering/electrical)
"bU" = (
/obj/machinery/atmospherics/components/binary/circulator{
	dir = 1
	},
/turf/open/floor/engine/air,
/area/ship/engineering/engine)
"cp" = (
/obj/machinery/atmospherics/components/binary/circulator/cold,
/obj/structure/cable/yellow{
	icon_state = "1-2"
	},
/turf/open/floor/engine/air,
/area/ship/engineering/engine)
"cq" = (
/obj/machinery/atmospherics/pipe/simple/dark/visible{
	dir = 5
	},
/turf/open/floor/plasteel/white,
/area/ship/engineering/engine)
"cN" = (
/turf/open/floor/plasteel/white,
/area/ship/engineering/engine)
"de" = (
/obj/structure/cable/yellow{
	icon_state = "1-8"
	},
/turf/closed/wall/mineral/titanium/nodiagonal,
/area/ship/engineering/electrical)
"dm" = (
/obj/machinery/door/airlock/research{
	name = "Robotics";
	dir = 4
	},
/turf/open/floor/plasteel/mono/white,
/area/ship/hallway/fore)
"dG" = (
/obj/structure/cable{
	icon_state = "2-4"
	},
/obj/structure/cable{
	icon_state = "4-8"
	},
/turf/open/floor/plasteel/white,
/area/ship/engineering/electrical)
"ea" = (
/obj/machinery/door/airlock/public{
	dir = 4;
	name = "Crew Quarters"
	},
/turf/open/floor/plasteel/mono/white,
/area/ship/crew)
"eP" = (
/turf/open/floor/plasteel/dark,
/area/ship/engineering/engine)
"eS" = (
/turf/closed/wall/mineral/titanium/nodiagonal,
/area/ship/hallway/starboard)
"fD" = (
/turf/closed/wall/mineral/titanium,
/area/ship/maintenance/port)
"fU" = (
/turf/closed/wall/mineral/titanium,
/area/space)
"gS" = (
/obj/structure/window/plasma/reinforced/spawner,
/obj/structure/window/plasma/reinforced/spawner/east,
/obj/structure/window/plasma/reinforced/spawner/north,
/obj/machinery/atmospherics/components/unary/outlet_injector/on/layer2{
	dir = 4;
	name = "nitrogen tank injector"
	},
/obj/machinery/atmospherics/pipe/simple/supply/visible/layer4{
	dir = 4
	},
/turf/open/floor/engine/n2,
/area/ship/engineering/atmospherics)
"hL" = (
/obj/machinery/power/shuttle/engine/electric{
	dir = 4
	},
/turf/open/floor/plating,
/area/ship/maintenance/port)
"hW" = (
/turf/open/floor/plasteel/white,
/area/ship/storage/eva)
"iS" = (
/obj/structure/window/plasma/reinforced/spawner,
/obj/structure/window/plasma/reinforced/spawner/east,
/obj/structure/window/plasma/reinforced/spawner/north,
/obj/machinery/atmospherics/components/unary/vent_pump/siphon/on{
	dir = 4
	},
/turf/open/floor/engine/plasma,
/area/ship/engineering/engine)
"iZ" = (
/turf/closed/wall/mineral/titanium/nodiagonal,
/area/ship/crew/canteen)
"jB" = (
/obj/machinery/door/airlock/mining{
	dir = 4;
	name = "EVA"
	},
/turf/open/floor/plasteel/mono/white,
/area/ship/storage/eva)
"ki" = (
/obj/machinery/door/airlock/medical{
	dir = 8;
	name = "Medbay"
	},
/turf/open/floor/plasteel/mono/white,
/area/ship/hallway/fore)
"kj" = (
/obj/effect/spawner/structure/window/plasma/reinforced,
/turf/open/floor/engine/air,
/area/ship/engineering/engine)
"kF" = (
/turf/open/floor/plasteel/mono/white,
/area/ship/security/armory)
"kO" = (
/obj/machinery/atmospherics/components/binary/pump,
/turf/open/floor/plasteel/white,
/area/ship/engineering/engine)
"kR" = (
/obj/machinery/door/airlock/maintenance_hatch{
	name = "Port Maintenance"
	},
/turf/open/floor/plasteel/mono/dark,
/area/ship/science/robotics)
"mw" = (
/obj/machinery/door/airlock/security{
	dir = 4;
	name = "Armory"
	},
/turf/open/floor/plasteel/mono/white,
/area/ship/security/armory)
"mD" = (
/obj/machinery/atmospherics/pipe/simple/supply/visible/layer4{
	dir = 9
	},
/turf/open/floor/plasteel/white,
/area/ship/engineering/atmospherics)
"mR" = (
/obj/machinery/atmospherics/pipe/simple/dark/visible{
	dir = 4
	},
/turf/open/floor/plasteel/white,
/area/ship/engineering/engine)
"nF" = (
/turf/closed/wall/mineral/titanium/nodiagonal,
/area/space)
"nT" = (
/obj/machinery/door/airlock/engineering{
	dir = 1;
	name = "Electrical"
	},
/turf/open/floor/plasteel/mono/white,
/area/ship/engineering/electrical)
"nY" = (
/obj/machinery/igniter{
	id = "KESTREL_IGNITER"
	},
/turf/open/floor/engine/airless,
/area/ship/engineering/engine)
"pL" = (
/turf/closed/wall/mineral/titanium,
/area/ship/bridge)
"qU" = (
/turf/open/floor/plasteel/white,
/area/ship/hallway/fore)
"ra" = (
/turf/open/floor/plasteel/white,
/area/ship/medical)
"se" = (
/obj/structure/cable{
	icon_state = "4-8"
	},
/turf/open/floor/plasteel/white,
/area/ship/engineering/electrical)
"st" = (
/turf/closed/wall/mineral/titanium/nodiagonal,
/area/ship/medical)
"sN" = (
/obj/machinery/door/airlock/mining{
	frequency = 1331;
	id_tag = "port_cargo_interior";
	name = "Port Cargo Bay"
	},
/turf/open/floor/plasteel/mono/white,
/area/ship/cargo/port)
"tb" = (
/turf/closed/wall/mineral/titanium,
/area/ship/hallway/port)
"tg" = (
/turf/open/floor/plasteel/white,
/area/ship/security)
"tu" = (
/obj/machinery/atmospherics/pipe/simple/supply/visible/layer4{
	dir = 4
	},
/turf/open/floor/plasteel/white,
/area/ship/engineering/atmospherics)
"tT" = (
/obj/machinery/atmospherics/pipe/manifold/supply/hidden/layer4{
	dir = 1
	},
/turf/open/floor/plasteel/white,
/area/ship/engineering/atmospherics)
"tW" = (
/obj/machinery/door/airlock/engineering{
	name = "Engine Room"
	},
/turf/open/floor/plasteel/mono/white,
/area/ship/engineering/engine)
"vb" = (
/obj/machinery/power/terminal{
	dir = 4
	},
/obj/structure/cable/yellow{
	icon_state = "0-2"
	},
/turf/open/floor/plasteel/white,
/area/ship/engineering/electrical)
"vx" = (
/obj/structure/cable{
	icon_state = "2-8"
	},
/obj/structure/cable{
	icon_state = "0-8"
	},
/obj/machinery/power/apc/auto_name/directional/north,
/turf/open/floor/plasteel/white,
/area/ship/engineering/electrical)
"wv" = (
/obj/machinery/atmospherics/components/trinary/mixer{
	dir = 4
	},
/turf/open/floor/plasteel/white,
/area/ship/engineering/engine)
"wX" = (
/turf/open/floor/plasteel/tech/grid,
/area/ship/storage/eva)
"xx" = (
/turf/open/floor/engine/hull/reinforced,
/area/ship/external)
"xK" = (
/turf/open/floor/plasteel/dark,
/area/ship/hallway/port)
"xV" = (
/turf/open/floor/plasteel/dark,
/area/ship/maintenance/port)
"zb" = (
/turf/closed/wall/mineral/titanium,
/area/ship/hallway/starboard)
"zt" = (
/turf/closed/wall/mineral/titanium,
/area/ship/storage/eva)
"zA" = (
/turf/open/floor/plasteel/stairs/right,
/area/ship/maintenance/port)
"zI" = (
/turf/template_noop,
/area/template_noop)
"zQ" = (
/turf/closed/wall/mineral/titanium/nodiagonal,
/area/ship/security)
"zY" = (
/obj/machinery/atmospherics/components/unary/outlet_injector{
	dir = 8
	},
/turf/open/floor/engine/airless,
/area/ship/engineering/engine)
"Ah" = (
/turf/closed/wall/mineral/titanium/nodiagonal,
/area/ship/security/armory)
"Ao" = (
/turf/closed/wall/mineral/titanium/nodiagonal,
/area/ship/hallway/port)
"Ay" = (
/turf/closed/wall/mineral/titanium/nodiagonal,
/area/ship/engineering/electrical)
"AJ" = (
/turf/open/floor/engine,
/area/ship/maintenance/port)
"Br" = (
/turf/open/floor/plasteel/stairs/left{
	dir = 1
	},
/area/ship/maintenance/port)
"BB" = (
/turf/open/floor/plasteel/dark,
/area/ship/hallway/starboard)
"BQ" = (
/turf/closed/wall/mineral/titanium/nodiagonal,
/area/ship/cargo/starboard)
"BT" = (
/obj/machinery/atmospherics/pipe/simple/dark/visible{
	dir = 9
	},
/turf/open/floor/plasteel/white,
/area/ship/engineering/engine)
"Cq" = (
/turf/closed/wall/mineral/titanium/nodiagonal,
/area/ship/bridge)
"Db" = (
/turf/closed/wall/mineral/titanium,
/area/ship/engineering/atmospherics)
"Df" = (
/obj/machinery/door/airlock/atmos{
	name = "Atmospherics";
	req_access_txt = "24";
	dir = 8
	},
/turf/open/floor/plasteel/mono/white,
/area/ship/engineering/atmospherics)
"Eh" = (
/turf/open/floor/plasteel/white,
/area/ship/science/robotics)
"Ez" = (
/obj/machinery/door/airlock/medical{
	dir = 1;
	name = "Medbay"
	},
/turf/open/floor/plasteel/mono/white,
/area/ship/medical)
"EM" = (
/turf/open/floor/plasteel/mono/white,
/area/space)
"ER" = (
/obj/machinery/door/airlock/maintenance_hatch{
	name = "Starboard Maintenance"
	},
/turf/open/floor/plasteel/mono/dark,
/area/ship/maintenance/port)
"ET" = (
/turf/closed/wall/mineral/titanium/nodiagonal,
/area/ship/storage/eva)
"Fv" = (
/obj/structure/cable/yellow{
	icon_state = "4-8"
	},
/turf/closed/wall/mineral/titanium/nodiagonal,
/area/ship/engineering/engine)
"Gx" = (
/obj/structure/cable/yellow{
	icon_state = "1-2"
	},
/obj/machinery/button/ignition{
	pixel_x = -10;
	dir = 8;
	pixel_y = 4;
	id = "KESTREL_IGNITER"
	},
/turf/closed/wall/mineral/titanium/nodiagonal,
/area/ship/engineering/engine)
"GA" = (
/turf/open/floor/plasteel/white,
/area/ship/security/armory)
"GH" = (
/turf/closed/wall/mineral/titanium/nodiagonal,
/area/ship/engineering/engine)
"GT" = (
/obj/machinery/door/airlock/security{
	dir = 4;
	name = "Security"
	},
/turf/open/floor/plasteel/mono/white,
/area/ship/security)
"GW" = (
/obj/machinery/atmospherics/components/trinary/mixer/airmix/inverse{
	dir = 4;
	piping_layer = 4
	},
/turf/open/floor/plasteel/white,
/area/ship/engineering/atmospherics)
"GZ" = (
/turf/open/floor/plasteel/white,
/area/ship/cargo)
"Hu" = (
/obj/machinery/door/airlock/command{
	dir = 4;
	name = "Bridge"
	},
/turf/open/floor/plasteel/mono/white,
/area/ship/science/robotics)
"HD" = (
/turf/open/floor/plasteel/stairs/right{
	dir = 1
	},
/area/ship/maintenance/port)
"Iw" = (
/obj/structure/cable/yellow{
	icon_state = "1-8"
	},
/obj/structure/cable/yellow{
	icon_state = "4-8"
	},
/turf/closed/wall/mineral/titanium/nodiagonal,
/area/ship/engineering/engine)
"IZ" = (
/obj/machinery/power/shuttle/engine/fueled/plasma{
	dir = 4
	},
/turf/open/floor/plating,
/area/ship/maintenance/port)
"Jh" = (
/obj/structure/window/plasma/reinforced/spawner,
/obj/structure/window/plasma/reinforced/spawner/east,
/obj/structure/window/plasma/reinforced/spawner/north,
/obj/machinery/atmospherics/components/unary/outlet_injector/on/layer2{
	dir = 4;
	name = "oxygen tank injector"
	},
/obj/machinery/atmospherics/pipe/simple/supply/visible/layer4{
	dir = 4
	},
/turf/open/floor/engine/air,
/area/ship/engineering/atmospherics)
"Jl" = (
/obj/machinery/door/airlock/medical{
	dir = 8;
	name = "Medbay"
	},
/turf/open/floor/plasteel/mono/white,
/area/ship/medical)
"Jz" = (
/obj/structure/window/plasma/reinforced/spawner,
/obj/structure/window/plasma/reinforced/spawner/north,
/obj/structure/window/plasma/reinforced/spawner/west,
/obj/effect/turf_decal/atmos/nitrogen,
/obj/machinery/atmospherics/components/unary/vent_pump/siphon/atmos/nitrogen_output{
	dir = 4;
	piping_layer = 4
	},
/turf/open/floor/engine/n2,
/area/ship/engineering/atmospherics)
"JY" = (
/obj/machinery/atmospherics/components/trinary/filter/atmos/flipped/o2{
	piping_layer = 2
	},
/obj/machinery/atmospherics/pipe/simple/supply/visible/layer4{
	dir = 4
	},
/turf/open/floor/plasteel/white,
/area/ship/engineering/atmospherics)
"Kl" = (
/obj/machinery/door/airlock/maintenance_hatch{
	name = "Port Maintenance";
	dir = 4
	},
/turf/open/floor/plasteel/mono/dark,
/area/ship/hallway/starboard)
"Ll" = (
/obj/machinery/power/generator{
	dir = 8
	},
/obj/structure/cable/yellow{
	icon_state = "1-2"
	},
/turf/open/floor/engine/air,
/area/ship/engineering/engine)
"NO" = (
/obj/machinery/door/airlock/engineering{
	name = "Engine Room"
	},
/obj/machinery/atmospherics/pipe/layer_manifold/visible,
/turf/open/floor/plasteel/mono/white,
/area/ship/engineering/engine)
"NV" = (
/obj/machinery/door/airlock/maintenance_hatch{
	name = "Starboard Maintenance";
	dir = 4
	},
/turf/open/floor/plasteel/mono/dark,
/area/ship/hallway/starboard)
"Op" = (
/obj/machinery/door/airlock/mining{
	name = "Starboard Cargo Bay"
	},
/turf/open/floor/plasteel/mono/white,
/area/ship/cargo/starboard)
"Or" = (
/turf/open/floor/plasteel/white,
/area/space)
"Ox" = (
/turf/closed/wall/mineral/titanium/nodiagonal,
/area/ship/cargo)
"Pf" = (
/obj/structure/window/plasma/reinforced/spawner,
/obj/structure/window/plasma/reinforced/spawner/west,
/obj/structure/window/plasma/reinforced/spawner/north,
/obj/effect/turf_decal/atmos/plasma,
/turf/open/floor/engine/plasma,
/area/ship/engineering/engine)
"Pt" = (
/turf/closed/wall/mineral/titanium/nodiagonal,
/area/ship/cargo/port)
"PA" = (
/obj/machinery/atmospherics/components/trinary/filter/atmos/flipped/n2{
	piping_layer = 2
	},
/obj/machinery/atmospherics/pipe/simple/supply/visible/layer4{
	dir = 4
	},
/turf/open/floor/plasteel/white,
/area/ship/engineering/atmospherics)
"PQ" = (
/turf/open/floor/plasteel/tech/grid,
/area/ship/cargo/starboard)
"PU" = (
/turf/open/floor/plasteel/white,
/area/ship/engineering/electrical)
"Qi" = (
/obj/machinery/door/airlock/maintenance_hatch{
	name = "Starboard Maintenance"
	},
/turf/open/floor/plasteel/mono/dark,
/area/ship/science/robotics)
"QF" = (
/obj/machinery/door/airlock/maintenance_hatch{
	name = "Port Maintenance";
	dir = 4
	},
/turf/open/floor/plasteel/mono/dark,
/area/ship/hallway/port)
"SP" = (
/turf/open/floor/plasteel/white,
/area/ship/cargo/starboard)
"Td" = (
/turf/open/floor/plasteel/tech/grid,
/area/ship/cargo/port)
"TB" = (
/obj/structure/cable/yellow{
	icon_state = "2-4"
	},
/turf/closed/wall/mineral/titanium/nodiagonal,
/area/ship/engineering/engine)
"TH" = (
/turf/closed/wall/mineral/titanium/nodiagonal,
/area/ship/hallway/fore)
"UW" = (
/obj/machinery/atmospherics/components/binary/pump{
	dir = 4
	},
/turf/open/floor/plasteel/white,
/area/ship/engineering/engine)
"Vl" = (
/turf/closed/wall/mineral/titanium/nodiagonal,
/area/ship/science/robotics)
"Vm" = (
/turf/open/floor/plasteel/white,
/area/ship/crew/canteen)
"Vn" = (
/obj/machinery/door/airlock/maintenance_hatch{
	name = "Port Maintenance"
	},
/turf/open/floor/plasteel/mono/dark,
/area/ship/maintenance/port)
"VO" = (
/turf/open/floor/plasteel/white,
/area/ship/cargo/port)
"VP" = (
/turf/closed/wall/mineral/titanium/nodiagonal,
/area/ship/engineering/atmospherics)
"Wi" = (
/turf/open/floor/plasteel/white,
/area/ship/crew)
"Wt" = (
/turf/open/floor/plasteel/white,
/area/ship/bridge)
"WC" = (
/obj/effect/spawner/structure/window/plasma/reinforced,
/obj/machinery/atmospherics/pipe/simple/dark/visible{
	dir = 4
	},
/turf/open/floor/engine/air,
/area/ship/engineering/engine)
"WL" = (
/turf/closed/wall/mineral/titanium/nodiagonal,
/area/ship/maintenance/port)
"WU" = (
/turf/open/floor/plasteel/stairs/medium,
/area/ship/maintenance/port)
"Yg" = (
/turf/open/floor/plasteel/stairs/left,
/area/ship/maintenance/port)
"Zp" = (
/obj/machinery/power/smes/engineering,
/obj/structure/cable,
/turf/open/floor/plasteel/white,
/area/ship/engineering/electrical)
"Zs" = (
/obj/machinery/atmospherics/components/unary/vent_scrubber/on/layer3{
	dir = 8
	},
/turf/open/floor/engine/airless,
/area/ship/engineering/engine)

(1,1,1) = {"
zI
zI
zI
zI
zI
zI
zI
zI
zI
zI
zt
wX
wX
wX
wX
wX
zt
zI
zI
zI
zI
zI
zI
zI
zI
zI
zI
"}
(2,1,1) = {"
zI
zI
zI
zI
zI
zI
zI
zI
zI
zt
ET
hW
hW
hW
hW
hW
ET
zt
zI
zI
zI
zI
zI
zI
zI
zI
zI
"}
(3,1,1) = {"
zI
zI
zI
zI
zI
zI
zI
zI
zt
ET
ET
hW
hW
hW
hW
hW
ET
ET
zt
zI
zI
zI
zI
zI
zI
zI
zI
"}
(4,1,1) = {"
zI
hL
IZ
hL
zI
zI
zI
Db
VP
VP
ET
ET
jB
ET
jB
ET
ET
nF
nF
fU
zI
zI
zI
hL
IZ
hL
zI
"}
(5,1,1) = {"
WL
AJ
AJ
AJ
WL
zI
zI
VP
Jz
ag
GH
cN
cN
Pf
cN
cN
GH
Or
Or
nF
zI
zI
WL
AJ
AJ
AJ
WL
"}
(6,1,1) = {"
WL
AJ
AJ
AJ
WL
zI
zI
VP
gS
Jh
GH
cN
cN
iS
cN
cN
GH
Or
Or
nF
zI
zI
WL
AJ
AJ
AJ
WL
"}
(7,1,1) = {"
WL
AJ
AJ
AJ
WL
zI
Db
VP
PA
JY
GH
cN
cN
UW
cN
cN
GH
Or
Or
nF
fU
zI
WL
AJ
AJ
AJ
WL
"}
(8,1,1) = {"
WL
AJ
AJ
AJ
WL
zI
VP
VP
tu
tT
NO
kO
cq
mR
cN
cN
tW
Or
Or
nF
nF
zI
WL
AJ
AJ
AJ
WL
"}
(9,1,1) = {"
WL
AJ
AJ
AJ
WL
zI
VP
VP
GW
mD
GH
cN
wv
BT
cN
cN
GH
Or
Or
nF
nF
zI
WL
AJ
AJ
AJ
WL
"}
(10,1,1) = {"
WL
AJ
AJ
AJ
WL
xx
VP
VP
Df
VP
TB
Gx
cp
Ll
bU
GH
GH
nF
EM
nF
nF
xx
WL
AJ
AJ
AJ
WL
"}
(11,1,1) = {"
WL
AJ
AJ
AJ
WL
WL
WL
Ay
PU
vb
Iw
eP
WC
kj
WC
eP
GH
Or
Or
nF
WL
WL
WL
AJ
AJ
AJ
WL
"}
(12,1,1) = {"
WL
AJ
AJ
AJ
Br
xV
xV
Ay
dG
Zp
Fv
eP
zY
nY
Zs
eP
GH
Or
Or
nF
xV
xV
Yg
AJ
AJ
AJ
WL
"}
(13,1,1) = {"
WL
AJ
AJ
AJ
aM
xV
xV
Ay
dG
Zp
Fv
GH
GH
GH
GH
GH
GH
Or
Or
nF
xV
xV
WU
AJ
AJ
AJ
WL
"}
(14,1,1) = {"
WL
AJ
AJ
AJ
aM
xV
xV
Ay
se
bP
de
GA
GA
GA
GA
GA
Ah
Or
Or
nF
xV
xV
WU
AJ
AJ
AJ
WL
"}
(15,1,1) = {"
WL
AJ
AJ
AJ
HD
xV
xV
Ay
vx
PU
nT
GA
GA
GA
GA
GA
kF
Or
Or
nF
xV
xV
zA
AJ
AJ
AJ
WL
"}
(16,1,1) = {"
fD
WL
WL
WL
WL
xV
xV
Ay
Ay
Ay
Ay
GA
GA
GA
GA
GA
Ah
nF
nF
nF
xV
xV
WL
WL
WL
WL
fD
"}
(17,1,1) = {"
zI
fD
WL
WL
WL
xV
xV
xV
xV
xV
Vn
GA
GA
GA
GA
GA
ER
xV
xV
xV
xV
xV
WL
WL
WL
fD
zI
"}
(18,1,1) = {"
zI
zI
zI
zI
WL
xV
xV
xV
xV
xV
Ah
GA
GA
GA
GA
GA
Ah
xV
xV
xV
xV
xV
WL
zI
zI
zI
zI
"}
(19,1,1) = {"
zI
zI
zI
zI
Pt
Pt
Pt
Pt
Ox
Ox
Ah
mw
Ah
Ah
Ah
mw
Ah
iZ
iZ
BQ
BQ
BQ
BQ
zI
zI
zI
zI
"}
(20,1,1) = {"
zI
zI
zI
zI
Td
VO
VO
Pt
GZ
GZ
GZ
GZ
GZ
Ox
Vm
Vm
Vm
Vm
Vm
BQ
SP
SP
PQ
zI
zI
zI
zI
"}
(21,1,1) = {"
zI
zI
zI
zI
Td
VO
VO
Pt
GZ
GZ
GZ
GZ
GZ
Ox
Vm
Vm
Vm
Vm
Vm
BQ
SP
SP
PQ
zI
zI
zI
zI
"}
(22,1,1) = {"
zI
zI
zI
zI
Td
VO
VO
Pt
GZ
GZ
GZ
GZ
GZ
Ox
Vm
Vm
Vm
Vm
Vm
BQ
SP
SP
PQ
zI
zI
zI
zI
"}
(23,1,1) = {"
zI
zI
zI
zI
Td
VO
VO
sN
GZ
GZ
GZ
GZ
GZ
Ox
Vm
Vm
Vm
Vm
Vm
Op
SP
SP
PQ
zI
zI
zI
zI
"}
(24,1,1) = {"
zI
zI
zI
zI
Td
VO
VO
Pt
GZ
GZ
GZ
GZ
GZ
Ox
Vm
Vm
Vm
Vm
Vm
BQ
SP
SP
PQ
zI
zI
zI
zI
"}
(25,1,1) = {"
zI
zI
zI
zI
Pt
Pt
Kl
Pt
Ox
Jl
Ox
Ox
Ox
Ox
iZ
iZ
iZ
ea
iZ
BQ
NV
BQ
BQ
zI
zI
zI
zI
"}
(26,1,1) = {"
zI
zI
zI
zI
eS
BB
BB
st
ra
ra
ra
ra
ra
st
Wi
Wi
Wi
Wi
Wi
eS
BB
BB
eS
zI
zI
zI
zI
"}
(27,1,1) = {"
zI
zI
zI
zI
zb
eS
BB
st
ra
ra
ra
ra
ra
Ez
Wi
Wi
Wi
Wi
Wi
eS
BB
eS
zb
zI
zI
zI
zI
"}
(28,1,1) = {"
zI
zI
zI
zI
zI
eS
BB
st
ra
ra
ra
ra
ra
st
Wi
Wi
Wi
Wi
Wi
eS
BB
eS
zI
zI
zI
zI
zI
"}
(29,1,1) = {"
zI
zI
zI
zI
zI
zb
eS
st
ra
ra
ra
ra
ra
st
Wi
Wi
Wi
Wi
Wi
eS
eS
zb
zI
zI
zI
zI
zI
"}
(30,1,1) = {"
zI
zI
zI
zI
zI
zI
eS
st
ra
ra
ra
ra
ra
st
Wi
Wi
Wi
Wi
Wi
eS
eS
zI
zI
zI
zI
zI
zI
"}
(31,1,1) = {"
zI
zI
zI
zI
zI
zI
tb
Ao
QF
Ao
TH
TH
ki
TH
GT
zQ
zQ
eS
NV
eS
zb
zI
zI
zI
zI
zI
zI
"}
(32,1,1) = {"
zI
zI
zI
zI
zI
zI
zI
Ao
xK
xK
TH
qU
qU
TH
tg
tg
zQ
BB
BB
eS
zI
zI
zI
zI
zI
zI
zI
"}
(33,1,1) = {"
zI
zI
zI
zI
zI
zI
zI
Ao
xK
xK
TH
qU
qU
TH
tg
tg
zQ
BB
BB
eS
zI
zI
zI
zI
zI
zI
zI
"}
(34,1,1) = {"
zI
zI
zI
zI
zI
zI
zI
Ao
xK
xK
TH
qU
qU
TH
tg
tg
zQ
BB
BB
eS
zI
zI
zI
zI
zI
zI
zI
"}
(35,1,1) = {"
zI
zI
zI
zI
zI
zI
zI
Ao
xK
xK
TH
qU
qU
TH
tg
tg
zQ
BB
BB
eS
zI
zI
zI
zI
zI
zI
zI
"}
(36,1,1) = {"
zI
zI
zI
zI
zI
zI
zI
tb
Ao
xK
TH
qU
qU
TH
tg
tg
zQ
BB
eS
zb
zI
zI
zI
zI
zI
zI
zI
"}
(37,1,1) = {"
zI
zI
zI
zI
zI
zI
zI
zI
Ao
xK
TH
TH
dm
TH
GT
zQ
zQ
BB
eS
zI
zI
zI
zI
zI
zI
zI
zI
"}
(38,1,1) = {"
zI
zI
zI
zI
zI
zI
zI
zI
Ao
xK
kR
Eh
Eh
Eh
Eh
Eh
Qi
BB
eS
zI
zI
zI
zI
zI
zI
zI
zI
"}
(39,1,1) = {"
zI
zI
zI
zI
zI
zI
zI
zI
Ao
xK
Vl
Eh
Eh
Eh
Eh
Eh
Vl
BB
eS
zI
zI
zI
zI
zI
zI
zI
zI
"}
(40,1,1) = {"
zI
zI
zI
zI
zI
zI
zI
zI
tb
Ao
Vl
Eh
Eh
Eh
Eh
Eh
Vl
eS
zb
zI
zI
zI
zI
zI
zI
zI
zI
"}
(41,1,1) = {"
zI
zI
zI
zI
zI
zI
zI
zI
zI
Vl
Vl
Eh
Eh
Eh
Eh
Eh
Vl
Vl
zI
zI
zI
zI
zI
zI
zI
zI
zI
"}
(42,1,1) = {"
zI
zI
zI
zI
zI
zI
zI
zI
zI
Vl
Vl
Eh
Eh
Eh
Eh
Eh
Vl
Vl
zI
zI
zI
zI
zI
zI
zI
zI
zI
"}
(43,1,1) = {"
zI
zI
zI
zI
zI
zI
zI
zI
zI
Cq
Vl
Vl
Vl
Vl
Hu
Vl
Vl
Cq
zI
zI
zI
zI
zI
zI
zI
zI
zI
"}
(44,1,1) = {"
zI
zI
zI
zI
zI
zI
zI
zI
zI
Cq
Cq
Wt
Wt
Wt
Wt
Wt
Cq
Cq
zI
zI
zI
zI
zI
zI
zI
zI
zI
"}
(45,1,1) = {"
zI
zI
zI
zI
zI
zI
zI
zI
zI
pL
Cq
Wt
Wt
Wt
Wt
Wt
Cq
pL
zI
zI
zI
zI
zI
zI
zI
zI
zI
"}
(46,1,1) = {"
zI
zI
zI
zI
zI
zI
zI
zI
zI
zI
pL
Cq
Cq
Cq
Cq
Cq
pL
zI
zI
zI
zI
zI
zI
zI
zI
zI
zI
"}
