//MAP CONVERTED BY dmm2tgm.py THIS HEADER COMMENT PREVENTS RECONVERSION, DO NOT REMOVE
"aQ" = (
/turf/closed/wall/mineral/titanium,
/area/ship/engineering/atmospherics)
"aR" = (
/obj/machinery/door/airlock/maintenance_hatch{
	name = "Starboard Maintenance"
	},
/turf/open/floor/plasteel/mono/dark,
/area/ship/maintenance/port)
"bn" = (
/obj/docking_port/stationary{
	dwidth = 10;
	width = 20;
	height = 15;
	dir = 2
	},
/turf/template_noop,
/area/template_noop)
"cu" = (
/obj/effect/spawner/structure/window/plasma/reinforced,
/turf/open/floor/engine/air,
/area/ship/engineering/engine)
"dH" = (
/turf/closed/wall/mineral/titanium/nodiagonal,
/area/space)
"er" = (
/obj/machinery/door/poddoor/shutters/preopen{
	id = "kestrel_dining";
	name = "Canteen Shutters"
	},
/turf/template_noop,
/area/template_noop)
"eM" = (
/obj/structure/cable{
	icon_state = "2-8"
	},
/obj/structure/cable{
	icon_state = "0-8"
	},
/obj/machinery/power/apc/auto_name/directional/north,
/turf/open/floor/plasteel/white,
/area/ship/engineering/electrical)
"fb" = (
/obj/machinery/door/airlock/maintenance_hatch{
	name = "Starboard Maintenance";
	dir = 4
	},
/turf/open/floor/plasteel/mono/dark,
/area/ship/hallway/starboard)
"fG" = (
/obj/structure/window/plasma/reinforced/spawner,
/obj/structure/window/plasma/reinforced/spawner/north,
/obj/structure/window/plasma/reinforced/spawner/west,
/obj/effect/turf_decal/atmos/nitrogen{
	pixel_x = 18
	},
/obj/machinery/atmospherics/components/unary/vent_pump/siphon/atmos/nitrogen_output{
	dir = 4;
	piping_layer = 4
	},
/turf/open/floor/engine/n2,
/area/ship/engineering/atmospherics)
"gl" = (
/obj/machinery/door/airlock/command{
	dir = 4;
	name = "Bridge"
	},
/turf/open/floor/plasteel/mono/white,
/area/ship/science/robotics)
"gn" = (
/turf/open/floor/plasteel/stairs/left{
	dir = 1
	},
/area/ship/maintenance/port)
"gp" = (
/obj/docking_port/mobile{
	dir = 4
	},
/turf/open/floor/plating,
/area/ship/bridge)
"gA" = (
/obj/machinery/power/smes/engineering,
/obj/structure/cable,
/turf/open/floor/plasteel/white,
/area/ship/engineering/electrical)
"gX" = (
/turf/open/floor/engine/airless,
/area/ship/engineering/engine)
"hL" = (
/obj/structure/window/plasma/reinforced/spawner,
/obj/structure/window/plasma/reinforced/spawner/east,
/obj/structure/window/plasma/reinforced/spawner/north,
/turf/open/floor/engine/air,
/area/ship/engineering/atmospherics)
"hW" = (
/obj/machinery/door/airlock/medical{
	dir = 1;
	name = "Medbay"
	},
/turf/open/floor/plasteel/mono/white,
/area/ship/medical)
"iD" = (
/obj/structure/cable/yellow{
	icon_state = "1-2"
	},
/turf/closed/wall/mineral/titanium/nodiagonal,
/area/ship/engineering/engine)
"iV" = (
/turf/closed/wall/mineral/titanium/nodiagonal,
/area/ship/medical)
"jx" = (
/turf/open/floor/plasteel/dark,
/area/ship/hallway/port)
"jy" = (
/obj/machinery/power/terminal{
	dir = 4
	},
/obj/structure/cable/yellow{
	icon_state = "0-2"
	},
/turf/open/floor/plasteel/white,
/area/ship/engineering/electrical)
"jD" = (
/obj/machinery/door/airlock/maintenance_hatch{
	name = "Starboard Maintenance"
	},
/turf/open/floor/plasteel/mono/dark,
/area/ship/science/robotics)
"jJ" = (
/obj/machinery/door/airlock/atmos{
	name = "Atmospherics";
	req_access_txt = "24";
	dir = 8
	},
/turf/open/floor/plasteel/mono/white,
/area/ship/engineering/atmospherics)
"jS" = (
/turf/open/floor/plasteel/white,
/area/ship/cargo/starboard)
"kc" = (
/turf/closed/wall/mineral/titanium/nodiagonal,
/area/ship/engineering/engine)
"kj" = (
/turf/open/floor/plating,
/area/ship/bridge)
"ku" = (
/obj/machinery/door/poddoor/shutters/preopen{
	id = "kestrel_starcargo";
	name = "Starboard Cargo Shutters"
	},
/turf/template_noop,
/area/template_noop)
"kP" = (
/obj/structure/window/plasma/reinforced/spawner,
/obj/structure/window/plasma/reinforced/spawner/east,
/obj/structure/window/plasma/reinforced/spawner/north,
/turf/open/floor/engine/n2,
/area/ship/engineering/atmospherics)
"lE" = (
/obj/machinery/atmospherics/components/trinary/filter/atmos/flipped/n2{
	piping_layer = 2
	},
/turf/open/floor/plasteel/white,
/area/ship/engineering/atmospherics)
"lG" = (
/turf/closed/wall/mineral/titanium/nodiagonal,
/area/ship/cargo/starboard)
"lJ" = (
/obj/structure/cable{
	icon_state = "4-8"
	},
/turf/open/floor/plasteel/white,
/area/ship/engineering/electrical)
"mr" = (
/turf/closed/wall/mineral/titanium/nodiagonal,
/area/ship/hallway/starboard)
"mH" = (
/obj/structure/cable/yellow{
	icon_state = "4-8"
	},
/turf/closed/wall/mineral/titanium/nodiagonal,
/area/ship/engineering/engine)
"nO" = (
/obj/machinery/button{
	pixel_y = 22;
	pixel_x = 6;
	id = "kestrel_dctrl";
	name = "Door Control"
	},
/obj/machinery/button{
	pixel_y = 22;
	pixel_x = -6
	},
/obj/machinery/button{
	pixel_y = 31;
	pixel_x = -6
	},
/obj/machinery/button{
	pixel_y = 31;
	pixel_x = 6;
	id = "kestrel_robotics";
	name = "Robotics"
	},
/obj/machinery/button{
	pixel_y = 40;
	pixel_x = -6
	},
/obj/machinery/button{
	pixel_y = 40;
	pixel_x = 6;
	name = "Bridge";
	id = "kestrel_bridge"
	},
/turf/open/floor/plasteel/white,
/area/ship/hallway/fore)
"nT" = (
/turf/closed/wall/mineral/titanium/nodiagonal,
/area/ship/storage/eva)
"pq" = (
/obj/machinery/door/poddoor/shutters/preopen{
	name = "Electrical Shutters";
	id = "kestrel_elec"
	},
/turf/template_noop,
/area/template_noop)
"px" = (
/obj/machinery/button{
	pixel_y = 31;
	pixel_x = -6
	},
/obj/machinery/button{
	pixel_y = 40
	},
/obj/machinery/button{
	pixel_y = 22
	},
/turf/open/floor/plasteel/white,
/area/ship/hallway/fore)
"pC" = (
/obj/machinery/power/shuttle/engine/electric{
	dir = 4
	},
/turf/open/floor/plating,
/area/ship/maintenance/port)
"pV" = (
/obj/machinery/door/poddoor/shutters/preopen{
	name = "Crew Quarter Shutters";
	id = "kestrel_crew"
	},
/turf/template_noop,
/area/template_noop)
"qc" = (
/obj/machinery/door/airlock/maintenance_hatch{
	name = "Port Maintenance"
	},
/turf/open/floor/plasteel/mono/dark,
/area/ship/maintenance/port)
"qp" = (
/turf/closed/wall/mineral/titanium/nodiagonal,
/area/ship/security/armory)
"ra" = (
/turf/open/floor/plasteel/tech/grid,
/area/ship/cargo/port)
"sa" = (
/obj/machinery/door/airlock/maintenance_hatch{
	name = "Port Maintenance";
	dir = 4
	},
/turf/open/floor/plasteel/mono/dark,
/area/ship/hallway/starboard)
"sh" = (
/obj/machinery/door/airlock/engineering{
	dir = 1;
	name = "Electrical"
	},
/turf/open/floor/plasteel/mono/white,
/area/ship/engineering/electrical)
"sq" = (
/obj/machinery/door/airlock/security{
	dir = 4;
	name = "Security"
	},
/turf/open/floor/plasteel/mono/white,
/area/ship/security)
"sA" = (
/turf/open/floor/plasteel/dark,
/area/ship/maintenance/port)
"sI" = (
/obj/machinery/door/airlock/maintenance_hatch{
	name = "Port Maintenance"
	},
/turf/open/floor/plasteel/mono/dark,
/area/ship/science/robotics)
"sL" = (
/obj/machinery/door/airlock/mining{
	name = "Starboard Cargo Bay"
	},
/turf/open/floor/plasteel/mono/white,
/area/ship/cargo/starboard)
"tO" = (
/turf/open/floor/engine/hull/reinforced,
/area/ship/external)
"tV" = (
/obj/machinery/door/poddoor/shutters/preopen{
	id = "kestrel_bridge";
	name = "Bridge Shutters"
	},
/turf/template_noop,
/area/template_noop)
"ua" = (
/obj/machinery/button{
	pixel_y = 22;
	pixel_x = 6
	},
/obj/machinery/button{
	pixel_y = 22;
	pixel_x = -6
	},
/obj/machinery/button{
	pixel_y = 31;
	pixel_x = -6
	},
/obj/machinery/button{
	pixel_y = 31;
	pixel_x = 6
	},
/obj/machinery/button{
	pixel_y = 40;
	pixel_x = -6
	},
/obj/machinery/button{
	pixel_y = 40;
	pixel_x = 6
	},
/turf/open/floor/plasteel/white,
/area/ship/hallway/fore)
"uD" = (
/turf/open/floor/plasteel/white,
/area/space)
"uK" = (
/obj/machinery/door/poddoor/shutters/preopen{
	name = "Robotics Shutters";
	id = "kestrel_robotics"
	},
/turf/template_noop,
/area/template_noop)
"va" = (
/obj/structure/cable{
	icon_state = "2-4"
	},
/obj/structure/cable{
	icon_state = "4-8"
	},
/turf/open/floor/plasteel/white,
/area/ship/engineering/electrical)
"vg" = (
/turf/closed/wall/mineral/titanium/nodiagonal,
/area/ship/maintenance/port)
"vr" = (
/obj/machinery/door/poddoor/shutters/preopen{
	name = "Armory Shutters";
	id = "kestrel_armory"
	},
/turf/template_noop,
/area/template_noop)
"vw" = (
/turf/open/floor/plasteel/stairs/left,
/area/ship/maintenance/port)
"vO" = (
/turf/open/floor/plasteel/white,
/area/ship/engineering/engine)
"wt" = (
/turf/closed/wall/mineral/titanium/nodiagonal,
/area/ship/science/robotics)
"xe" = (
/turf/closed/wall/mineral/titanium,
/area/ship/storage/eva)
"xj" = (
/turf/open/floor/plasteel/tech/grid,
/area/ship/cargo/starboard)
"xx" = (
/obj/machinery/door/poddoor/shutters/preopen,
/turf/template_noop,
/area/template_noop)
"yd" = (
/obj/structure/window/plasma/reinforced/spawner,
/obj/structure/window/plasma/reinforced/spawner/west,
/obj/structure/window/plasma/reinforced/spawner/north,
/obj/effect/turf_decal/atmos/plasma,
/turf/open/floor/engine/plasma,
/area/ship/engineering/engine)
"yA" = (
/turf/open/floor/plasteel/stairs/right{
	dir = 1
	},
/area/ship/maintenance/port)
"yK" = (
/obj/machinery/door/airlock/mining{
	frequency = 1331;
	id_tag = "port_cargo_interior";
	name = "Port Cargo Bay"
	},
/turf/open/floor/plasteel/mono/white,
/area/ship/cargo/port)
"yT" = (
/turf/closed/wall/mineral/titanium,
/area/space)
"za" = (
/turf/closed/wall/mineral/titanium/nodiagonal,
/area/ship/engineering/electrical)
"zl" = (
/turf/open/floor/plasteel/dark,
/area/ship/hallway/starboard)
"zA" = (
/obj/structure/cable/yellow{
	icon_state = "1-8"
	},
/turf/closed/wall/mineral/titanium/nodiagonal,
/area/ship/engineering/electrical)
"zI" = (
/turf/open/floor/plasteel/white,
/area/ship/cargo/port)
"Ax" = (
/turf/open/floor/plasteel/white,
/area/ship/hallway/fore)
"BY" = (
/obj/structure/cable/yellow{
	icon_state = "1-8"
	},
/obj/structure/cable/yellow{
	icon_state = "4-8"
	},
/turf/closed/wall/mineral/titanium/nodiagonal,
/area/ship/engineering/engine)
"CN" = (
/turf/closed/wall/mineral/titanium/nodiagonal,
/area/ship/bridge)
"CR" = (
/obj/machinery/button{
	pixel_y = 40
	},
/obj/machinery/button{
	pixel_y = 31;
	pixel_x = 6
	},
/obj/machinery/button{
	pixel_y = 22;
	pixel_x = 6
	},
/obj/machinery/button{
	pixel_y = 31;
	pixel_x = -6
	},
/obj/machinery/button{
	pixel_y = 22;
	pixel_x = -6
	},
/turf/open/floor/plasteel/white,
/area/ship/hallway/fore)
"Df" = (
/obj/machinery/door/poddoor/shutters/preopen{
	name = "Door Control Shutters";
	id = "kestrel_dctrl"
	},
/turf/template_noop,
/area/template_noop)
"Du" = (
/obj/machinery/door/poddoor/shutters/preopen{
	name = "Atmospherics Shutters";
	id = "kestrel_atmos"
	},
/turf/template_noop,
/area/template_noop)
"DA" = (
/turf/closed/wall/mineral/titanium/nodiagonal,
/area/ship/cargo/port)
"DB" = (
/obj/machinery/door/airlock/engineering{
	name = "Engine Room"
	},
/turf/open/floor/plasteel/mono/white,
/area/ship/engineering/engine)
"DT" = (
/obj/machinery/door/poddoor/shutters/preopen{
	name = "Port Cargo Shutters";
	id = "kestrel_portcargo"
	},
/turf/template_noop,
/area/template_noop)
"Eo" = (
/obj/machinery/door/airlock/maintenance_hatch{
	name = "Port Maintenance";
	dir = 4
	},
/turf/open/floor/plasteel/mono/dark,
/area/ship/hallway/port)
"Gm" = (
/turf/open/floor/plasteel/dark,
/area/ship/engineering/engine)
"Gp" = (
/obj/machinery/atmospherics/components/trinary/filter/atmos/flipped/o2{
	piping_layer = 2
	},
/turf/open/floor/plasteel/white,
/area/ship/engineering/atmospherics)
"GH" = (
/turf/open/floor/plasteel/white,
/area/ship/engineering/atmospherics)
"HP" = (
/obj/machinery/power/terminal{
	dir = 8
	},
/obj/structure/cable/yellow{
	icon_state = "0-2"
	},
/turf/open/floor/plasteel/white,
/area/ship/engineering/electrical)
"HS" = (
/turf/open/floor/plasteel/white,
/area/ship/medical)
"IB" = (
/turf/open/floor/plasteel/white,
/area/ship/storage/eva)
"IS" = (
/obj/machinery/door/airlock/medical{
	dir = 8;
	name = "Medbay"
	},
/turf/open/floor/plasteel/mono/white,
/area/ship/hallway/fore)
"Jj" = (
/turf/closed/wall/mineral/titanium/nodiagonal,
/area/ship/cargo)
"Ju" = (
/turf/open/floor/plasteel/stairs/medium,
/area/ship/maintenance/port)
"JE" = (
/obj/machinery/atmospherics/components/binary/circulator/cold,
/obj/structure/cable/yellow{
	icon_state = "1-2"
	},
/turf/open/floor/engine/air,
/area/ship/engineering/engine)
"JY" = (
/turf/closed/wall/mineral/titanium/nodiagonal,
/area/ship/engineering/atmospherics)
"Ke" = (
/turf/open/floor/plasteel/white,
/area/ship/science/robotics)
"Kz" = (
/obj/docking_port/stationary{
	dwidth = 10;
	width = 20;
	height = 15
	},
/turf/template_noop,
/area/template_noop)
"KR" = (
/turf/closed/wall/mineral/titanium,
/area/ship/hallway/starboard)
"Lt" = (
/turf/open/floor/plasteel/white,
/area/ship/engineering/electrical)
"Lz" = (
/turf/open/floor/plasteel/mono/white,
/area/space)
"LM" = (
/obj/machinery/door/airlock/public{
	dir = 4;
	name = "Crew Quarters"
	},
/turf/open/floor/plasteel/mono/white,
/area/ship/crew)
"LQ" = (
/turf/closed/wall/mineral/titanium/nodiagonal,
/area/ship/security)
"Mn" = (
/turf/open/floor/plasteel/stairs/medium{
	dir = 1
	},
/area/ship/maintenance/port)
"Mr" = (
/turf/open/floor/plasteel/stairs/right,
/area/ship/maintenance/port)
"Mv" = (
/turf/open/floor/plasteel/mono/white,
/area/ship/security/armory)
"Nc" = (
/turf/open/floor/plasteel/white,
/area/ship/security/armory)
"Nw" = (
/obj/machinery/door/poddoor/shutters/preopen{
	name = "Engineering Shutters";
	id = "kestrel_engine"
	},
/turf/template_noop,
/area/template_noop)
"NH" = (
/obj/machinery/door/poddoor/shutters/preopen{
	name = "Medbay Shutters";
	id = "kestrel_med"
	},
/turf/template_noop,
/area/template_noop)
"Ok" = (
/obj/machinery/door/poddoor/shutters/preopen{
	name = "EVA Shutters";
	id = "kestrel_eva"
	},
/turf/template_noop,
/area/template_noop)
"Ou" = (
/turf/open/floor/plasteel/white,
/area/ship/cargo)
"OG" = (
/turf/open/floor/plasteel/white,
/area/ship/crew/canteen)
"PQ" = (
/obj/machinery/atmospherics/components/binary/circulator{
	dir = 1
	},
/turf/open/floor/engine/air,
/area/ship/engineering/engine)
"Qj" = (
/turf/open/floor/plasteel/white,
/area/ship/crew)
"Qx" = (
/obj/machinery/power/generator{
	dir = 8
	},
/obj/structure/cable/yellow{
	icon_state = "1-2"
	},
/turf/open/floor/engine/air,
/area/ship/engineering/engine)
"QX" = (
/turf/open/floor/plasteel/white,
/area/ship/bridge)
"Rb" = (
/obj/machinery/door/poddoor/shutters/preopen{
	name = "Security Shutters";
	id = "kestrel_sec"
	},
/turf/template_noop,
/area/template_noop)
"RG" = (
/obj/machinery/door/airlock/mining{
	dir = 4;
	name = "EVA"
	},
/turf/open/floor/plasteel/mono/white,
/area/ship/storage/eva)
"RK" = (
/obj/machinery/atmospherics/components/trinary/mixer/airmix{
	dir = 4;
	piping_layer = 4
	},
/turf/open/floor/plasteel/white,
/area/ship/engineering/atmospherics)
"SV" = (
/obj/machinery/door/airlock/security{
	dir = 4;
	name = "Armory"
	},
/turf/open/floor/plasteel/mono/white,
/area/ship/security/armory)
"SX" = (
/obj/structure/window/plasma/reinforced/spawner,
/obj/structure/window/plasma/reinforced/spawner/east,
/obj/structure/window/plasma/reinforced/spawner/north,
/turf/open/floor/engine/plasma,
/area/ship/engineering/engine)
"Vf" = (
/obj/machinery/power/shuttle/engine/fueled/plasma{
	dir = 4
	},
/turf/open/floor/plating,
/area/ship/maintenance/port)
"VM" = (
/obj/machinery/door/airlock/research{
	name = "Robotics";
	dir = 4
	},
/turf/open/floor/plasteel/mono/white,
/area/ship/hallway/fore)
"VN" = (
/turf/template_noop,
/area/template_noop)
"VT" = (
/turf/closed/wall/mineral/titanium,
/area/ship/maintenance/port)
"Wh" = (
/turf/open/floor/plasteel/tech/grid,
/area/ship/storage/eva)
"WY" = (
/obj/machinery/door/poddoor/shutters/preopen{
	name = "Cargo Shutters";
	id = "kestrel_cargo"
	},
/turf/template_noop,
/area/template_noop)
"Xi" = (
/turf/closed/wall/mineral/titanium/nodiagonal,
/area/ship/crew/canteen)
"XM" = (
/turf/closed/wall/mineral/titanium,
/area/ship/hallway/port)
"Yo" = (
/turf/closed/wall/mineral/titanium/nodiagonal,
/area/ship/hallway/fore)
"YU" = (
/obj/structure/window/plasma/reinforced/spawner,
/obj/structure/window/plasma/reinforced/spawner/north,
/obj/structure/window/plasma/reinforced/spawner/west,
/obj/machinery/atmospherics/components/unary/vent_pump/siphon/atmos/oxygen_output{
	dir = 4;
	piping_layer = 4
	},
/obj/effect/turf_decal/atmos/oxygen{
	pixel_x = 17
	},
/turf/open/floor/engine/air,
/area/ship/engineering/atmospherics)
"Zg" = (
/obj/structure/cable/yellow{
	icon_state = "2-4"
	},
/turf/closed/wall/mineral/titanium/nodiagonal,
/area/ship/engineering/engine)
"Zp" = (
/turf/open/floor/plasteel/white,
/area/ship/security)
"Zy" = (
/turf/open/floor/engine,
/area/ship/maintenance/port)
"ZE" = (
/obj/machinery/door/airlock/medical{
	dir = 8;
	name = "Medbay"
	},
/turf/open/floor/plasteel/mono/white,
/area/ship/medical)
"ZN" = (
/turf/closed/wall/mineral/titanium,
/area/ship/bridge)
"ZV" = (
/turf/closed/wall/mineral/titanium/nodiagonal,
/area/ship/hallway/port)

(1,1,1) = {"
VN
VN
VN
VN
VN
VN
VN
VN
VN
VN
xe
Wh
Wh
Wh
Wh
Wh
xe
VN
VN
VN
VN
VN
VN
VN
VN
VN
VN
"}
(2,1,1) = {"
VN
VN
VN
VN
VN
VN
VN
VN
VN
xe
nT
IB
IB
IB
IB
IB
nT
xe
VN
VN
VN
VN
VN
VN
VN
VN
VN
"}
(3,1,1) = {"
VN
VN
VN
VN
VN
VN
VN
VN
xe
nT
nT
IB
IB
IB
IB
IB
nT
nT
xe
VN
VN
VN
VN
VN
VN
VN
VN
"}
(4,1,1) = {"
VN
pC
Vf
pC
VN
VN
VN
aQ
JY
JY
nT
nT
RG
nT
RG
nT
nT
dH
dH
yT
VN
VN
VN
pC
Vf
pC
VN
"}
(5,1,1) = {"
vg
Zy
Zy
Zy
vg
VN
VN
JY
YU
fG
kc
yd
vO
vO
vO
vO
kc
uD
uD
dH
VN
VN
vg
Zy
Zy
Zy
vg
"}
(6,1,1) = {"
vg
Zy
Zy
Zy
vg
VN
VN
JY
hL
kP
kc
SX
vO
vO
vO
vO
kc
uD
uD
dH
VN
VN
vg
Zy
Zy
Zy
vg
"}
(7,1,1) = {"
vg
Zy
Zy
Zy
vg
VN
aQ
JY
Gp
lE
kc
vO
vO
vO
vO
vO
kc
uD
uD
dH
yT
VN
vg
Zy
Zy
Zy
vg
"}
(8,1,1) = {"
vg
Zy
Zy
Zy
vg
VN
JY
JY
RK
GH
DB
vO
vO
vO
vO
vO
DB
uD
uD
dH
dH
VN
vg
Zy
Zy
Zy
vg
"}
(9,1,1) = {"
vg
Zy
Zy
Zy
vg
VN
JY
JY
GH
GH
kc
vO
vO
vO
vO
vO
kc
uD
uD
dH
dH
VN
vg
Zy
Zy
Zy
vg
"}
(10,1,1) = {"
vg
Zy
Zy
Zy
vg
tO
JY
JY
jJ
JY
Zg
iD
JE
Qx
PQ
kc
kc
dH
Lz
dH
dH
tO
vg
Zy
Zy
Zy
vg
"}
(11,1,1) = {"
vg
Zy
Zy
Zy
vg
vg
vg
za
Lt
jy
BY
Gm
cu
cu
cu
Gm
kc
uD
uD
dH
vg
vg
vg
Zy
Zy
Zy
vg
"}
(12,1,1) = {"
vg
Zy
Zy
Zy
gn
sA
sA
za
va
gA
mH
Gm
gX
gX
gX
Gm
kc
uD
uD
dH
sA
sA
vw
Zy
Zy
Zy
vg
"}
(13,1,1) = {"
vg
Zy
Zy
Zy
Mn
sA
sA
za
va
gA
mH
kc
kc
kc
kc
kc
kc
uD
uD
dH
sA
sA
Ju
Zy
Zy
Zy
vg
"}
(14,1,1) = {"
vg
Zy
Zy
Zy
Mn
sA
sA
za
lJ
HP
zA
Nc
Nc
Nc
Nc
Nc
qp
uD
uD
dH
sA
sA
Ju
Zy
Zy
Zy
vg
"}
(15,1,1) = {"
vg
Zy
Zy
Zy
yA
sA
sA
za
eM
Lt
sh
Nc
Nc
Nc
Nc
Nc
Mv
uD
uD
dH
sA
sA
Mr
Zy
Zy
Zy
vg
"}
(16,1,1) = {"
VT
vg
vg
vg
vg
sA
sA
za
za
za
za
Nc
Nc
Nc
Nc
Nc
qp
dH
dH
dH
sA
sA
vg
vg
vg
vg
VT
"}
(17,1,1) = {"
VN
VT
vg
vg
vg
sA
sA
sA
sA
sA
qc
Nc
Nc
Nc
Nc
Nc
aR
sA
sA
sA
sA
sA
vg
vg
vg
VT
VN
"}
(18,1,1) = {"
VN
VN
VN
VN
vg
sA
sA
sA
sA
sA
qp
Nc
Nc
Nc
Nc
Nc
qp
sA
sA
sA
sA
sA
vg
VN
VN
VN
VN
"}
(19,1,1) = {"
VN
VN
VN
VN
DA
DA
DA
DA
Jj
Jj
qp
SV
qp
qp
qp
SV
qp
Xi
Xi
lG
lG
lG
lG
VN
VN
VN
VN
"}
(20,1,1) = {"
VN
VN
VN
VN
ra
zI
zI
DA
Ou
Ou
Ou
Ou
Ou
Jj
OG
OG
OG
OG
OG
lG
jS
jS
xj
VN
VN
VN
VN
"}
(21,1,1) = {"
VN
VN
VN
VN
ra
zI
zI
DA
Ou
Ou
Ou
Ou
Ou
Jj
OG
OG
OG
OG
OG
lG
jS
jS
xj
VN
VN
VN
VN
"}
(22,1,1) = {"
VN
VN
VN
Kz
ra
zI
zI
DA
Ou
Ou
Ou
Ou
Ou
Jj
OG
OG
OG
OG
OG
lG
jS
jS
xj
bn
VN
VN
VN
"}
(23,1,1) = {"
VN
VN
VN
VN
ra
zI
zI
yK
Ou
Ou
Ou
Ou
Ou
Jj
OG
OG
OG
OG
OG
sL
jS
jS
xj
VN
VN
VN
VN
"}
(24,1,1) = {"
VN
VN
VN
VN
ra
zI
zI
DA
Ou
Ou
Ou
Ou
Ou
Jj
OG
OG
OG
OG
OG
lG
jS
jS
xj
VN
VN
VN
VN
"}
(25,1,1) = {"
VN
VN
VN
VN
DA
DA
sa
DA
Jj
ZE
Jj
Jj
Jj
Jj
Xi
Xi
Xi
LM
Xi
lG
fb
lG
lG
VN
VN
VN
VN
"}
(26,1,1) = {"
VN
VN
VN
VN
mr
zl
zl
iV
HS
HS
HS
HS
HS
iV
Qj
Qj
Qj
Qj
Qj
mr
zl
zl
mr
VN
VN
VN
VN
"}
(27,1,1) = {"
VN
VN
VN
VN
KR
mr
zl
iV
HS
HS
HS
HS
HS
hW
Qj
Qj
Qj
Qj
Qj
mr
zl
mr
KR
VN
VN
VN
VN
"}
(28,1,1) = {"
VN
VN
VN
VN
VN
mr
zl
iV
HS
HS
HS
HS
HS
iV
Qj
Qj
Qj
Qj
Qj
mr
zl
mr
VN
VN
VN
VN
VN
"}
(29,1,1) = {"
VN
VN
VN
VN
VN
KR
mr
iV
HS
HS
HS
HS
HS
iV
Qj
Qj
Qj
Qj
Qj
mr
mr
KR
VN
VN
VN
VN
VN
"}
(30,1,1) = {"
VN
VN
VN
VN
VN
VN
mr
iV
HS
HS
HS
HS
HS
iV
Qj
Qj
Qj
Qj
Qj
mr
mr
VN
VN
VN
VN
VN
VN
"}
(31,1,1) = {"
VN
VN
VN
VN
VN
VN
XM
ZV
Eo
ZV
Yo
Yo
IS
Yo
sq
LQ
LQ
mr
fb
mr
KR
VN
VN
VN
VN
VN
VN
"}
(32,1,1) = {"
VN
VN
VN
VN
VN
VN
VN
ZV
jx
jx
Yo
px
Ax
Yo
Zp
Zp
LQ
zl
zl
mr
VN
VN
tV
vr
VN
VN
VN
"}
(33,1,1) = {"
VN
VN
VN
VN
VN
VN
VN
ZV
jx
jx
Yo
ua
Ax
Yo
Zp
Zp
LQ
zl
zl
mr
VN
VN
uK
pq
VN
VN
VN
"}
(34,1,1) = {"
VN
VN
VN
VN
VN
VN
VN
ZV
jx
jx
Yo
CR
Ax
Yo
Zp
Zp
LQ
zl
zl
mr
VN
VN
Df
Du
VN
VN
VN
"}
(35,1,1) = {"
VN
VN
VN
VN
VN
VN
VN
ZV
jx
jx
Yo
nO
Ax
Yo
Zp
Zp
LQ
zl
zl
mr
VN
VN
Rb
Nw
VN
VN
VN
"}
(36,1,1) = {"
VN
VN
VN
VN
VN
VN
VN
XM
ZV
jx
Yo
Ax
Ax
Yo
Zp
Zp
LQ
zl
mr
KR
VN
VN
NH
Ok
VN
VN
VN
"}
(37,1,1) = {"
VN
VN
VN
VN
VN
VN
VN
VN
ZV
jx
Yo
Yo
VM
Yo
sq
LQ
LQ
zl
mr
VN
VN
VN
pV
xx
VN
VN
VN
"}
(38,1,1) = {"
VN
VN
VN
VN
VN
VN
VN
VN
ZV
jx
sI
Ke
Ke
Ke
Ke
Ke
jD
zl
mr
VN
VN
VN
er
xx
VN
VN
VN
"}
(39,1,1) = {"
VN
VN
VN
VN
VN
VN
VN
VN
ZV
jx
wt
Ke
Ke
Ke
Ke
Ke
wt
zl
mr
VN
VN
VN
ku
VN
VN
VN
VN
"}
(40,1,1) = {"
VN
VN
VN
VN
VN
VN
VN
VN
XM
ZV
wt
Ke
Ke
Ke
Ke
Ke
wt
mr
KR
VN
VN
VN
DT
VN
VN
VN
VN
"}
(41,1,1) = {"
VN
VN
VN
VN
VN
VN
VN
VN
VN
wt
wt
Ke
Ke
Ke
Ke
Ke
wt
wt
VN
VN
VN
VN
WY
VN
VN
VN
VN
"}
(42,1,1) = {"
VN
VN
VN
VN
VN
VN
VN
VN
VN
wt
wt
Ke
Ke
Ke
Ke
Ke
wt
wt
VN
VN
VN
VN
VN
VN
VN
VN
VN
"}
(43,1,1) = {"
VN
VN
VN
VN
VN
VN
VN
VN
VN
CN
wt
wt
wt
wt
gl
wt
wt
CN
VN
VN
VN
VN
VN
VN
VN
VN
VN
"}
(44,1,1) = {"
VN
VN
VN
VN
VN
VN
VN
VN
VN
CN
CN
QX
QX
QX
QX
QX
CN
CN
VN
VN
VN
VN
VN
VN
VN
VN
VN
"}
(45,1,1) = {"
VN
VN
VN
VN
VN
VN
VN
VN
VN
ZN
CN
QX
QX
QX
QX
QX
CN
ZN
VN
VN
VN
VN
VN
VN
VN
VN
VN
"}
(46,1,1) = {"
VN
VN
VN
VN
VN
VN
VN
VN
VN
VN
ZN
kj
kj
gp
kj
kj
ZN
VN
VN
VN
VN
VN
VN
VN
VN
VN
VN
"}
